20 15
**^^^^^^^^^^^^^^^^**!
*^^^^^^^^^^^^^^^^^^*!
^^^^^^^^^^^^^^^^^^^^!
^^^^^^^......^^^^^^^!
^^^^^^.FFFFFF.^^^^^^!
.^^^^^...FF...^^^^^.!
*^^^^^^  ##  ^^^^^^*!
*^^^^^^ 1##2 ^^^^^^*!
*^^^^^^  ##  ^^^^^^*!
.^^^^^...FF...^^^^^.!
^^^^^^.FFFFFF.^^^^^^!
^^^^^^^......^^^^^^^!
^^^^^^^^^^^^^^^^^^^^!
*^^^^^^^^^^^^^^^^^^*!
**^^^^^^^^^^^^^^^^**!

# - Кирпичная стена   1,2 - Позиция первого и второго игроков
