20 15
##         EEEE#####!
           EEEE#####!
 # ######  EEEE#####!
 # ###     EEEE#####!
 # ### ## #    #####!
     #         #####!
 ### # ## # #  #####!
 ### # ## # #  #####!
 ##         #  #####!
 ## ## ######  #####!
 #1  #    ###  #####!
   &   ## ###  #####!
##  2####      #####!
### ##### ### ######!
###           ######!

# - Кирпичная стена   1,2 - Позиция первого и второго игроков
