20 15
&@1@#  3## @    ****!
@@ ##@  ## @    ****!
2  #@@# #  @    ****!
 #   ## #  @    ****!
##@@ #@ #@@#....    !
#@@# @@ #@@#....    !
  ##    #     ..    !
  #@@#@ #   4 ..    !
 @ @##@ #@##  ##@@@@!
@@# #@@ #@@#  @@    !
@##  @# @@@@  @@  ##!
@#@  ## @@######..##!
@@@# #     @@@     @!
  ##   ... #@###..#@!
  #        #@@     @!

# - Кирпичная стена   1,2 - Позиция первого и второго игроков
