20 15
J J J 5#6*  *@#@*  *!
 # # # #*@@@ @#@ @@ !
J J J J# @#@ @#@ @# !
 # # # # @#@ @#@ @@ !
4 J J J# @@@ @@@ @# !
########*   *   *@#7!
####################!
3      *###   F   .8!
 ##  ## ##    .  .^^!
 #1   # #    .  .^^.!
   ##   # F .  .^^. !
   ##   #  . F.^^.  !
 #   2# #^.  .^^.  F!
 ##  ## #^.   ^.    !
*      0#9.      F  !

# - Кирпичная стена   1,2 - Позиция первого и второго игроков
