20 15
....................!
       .  J       J.!
J....... . ..... . .!
 .    J  .  J    . .!
 . ... ..... ..... .!
 . . . .J       J  .!
  J  . . . . ... . .!
 ..... . . .   . . .!
   J   . . ... . . .!
#.. .... .J   J  . .!
         . ... ... .!
 ... ... . . . .  J.!
1  .   .  J. . . . .!
@@ . . . . . . . . .!
&@2  #   . .J J  . .!

# - Кирпичная стена   1,2 - Позиция первого и второго игроков
