20 15
      .     # .@    ! 
 # #    . . # .     !
     .. ... # .@ @@@!
 # #     F       @@@!
     #@@##@@#    @@@!
 # # @ E  E @ .@    !
     @      @ .@@   !
 # # # E  E # .@@ @ !
     #      # ......!
 # # @@#  #@@       !
^^^             #   !
^^^ @@  .   @@@ #   !
. . @@ ...  @@@ #   !
@@.     .   @@@ #@@@!
1  @ #    #     #  2! 

# - Кирпичная стена   1,2 - Позиция первого и второго игроков
