20 15
@@@    #        * * !
@## ## .         * *!
    @#       ###* * !
 ##@## .     @ # * *!
 ##@## #   ..# #    !
  2      ##..###    !
@@ @@  /   ^^^^^    !
&@ @@ /    ^^^^^  /#!
@@ @@      ^^^^^####!
  1     /  ^^^^^  \#!
 #     /   ^^^^^    !
  @#\      ##..#* * !
 #@..            * *!
  @#/    .      * * !
##@     ...      * *!

# - Кирпичная стена   1,2 - Позиция первого и второго игроков
