20 15
   @     @@@@   .   ! 
 1 @  .  @@@@       !
  &@ .#     # # ..@.!
@@@@  ###    @# .@@.!
     *^^^^^^* # .@..!
 ###*^^^^^^^^*#   # !
   ##^^^^^^^^       !
#   #^^^^^^^^    ^^^!
##   ^^^^^#^^## @@@@!
    #*^^^^^^*## ####!
  ##  *    *        !
^^^  ##    #^^  @@@@!
@^.^#   ^^^.^^  @&  !
^.^@#  ^^^^#^^  @ 2 !
@^@^#  ^^^^#    @   ! 

# - Кирпичная стена   1,2 - Позиция первого и второго игроков
